level 1

###       
#O####    
######### 
 #########
     ##X##
      ### 

level 3

      #######  
####  ###  ##  
#########  ####
#O##       ##X#
####       ####
            ###

level -1

##################
##################
##################
##################
#####O############
###############X##
##################
##################

level -2

#####O#################X#####