{
    "grid": [
        [0, 0, 0, 1, 1, 1, 1, 1, 1, 1, 0, 0, 0, 0],
        [0, 0, 0, 1, 1, 1, 1, 1, 1, 1, 0, 0, 0, 0],
        [1, 1, 1, 1, 0, 0, 0, 0, 0, 1, 1, 1, 0, 0],
        [1, 1, 1, 0, 0, 0, 0, 0, 0, 0, 1, 1, 0, 0],
        [1, 1, 1, 0, 0, 0, 0, 0, 0, 0, 1, 1, 0, 0],
        [1, 1, 1, 0, 0, 1, 1, 1, 1, 1, 1, 1, 1, 1],
        [1, 1, 1, 0, 0, 1, 1, 1, 1, 1, 1, 1, 1, 1],
        [0, 0, 0, 0, 0, 1, 1, 1, 0, 0, 1, 1, 1, 1],
        [0, 0, 0, 0, 0, 1, 1, 1, 0, 0, 1, 1, 1, 1]
    ],

    "start": [5, 1],
    "end": [7, 6],

    "red_grid":[
        [0, 0, 0, 1, 1, 1, 1, 1, 1, 1, 0, 0, 0, 0],
        [0, 0, 0, 1, 1, 1, 1, 1, 1, 1, 0, 0, 0, 0],
        [0, 0, 0, 0, 0, 0, 0, 0, 0, 0, 0, 0, 0, 0],
        [0, 0, 0, 0, 0, 0, 0, 0, 0, 0, 0, 0, 0, 0],
        [0, 0, 0, 0, 0, 0, 0, 0, 0, 0, 0, 0, 0, 0],
        [0, 0, 0, 0, 0, 0, 0, 0, 0, 1, 1, 1, 1, 1],
        [0, 0, 0, 0, 0, 0, 0, 0, 0, 1, 1, 1, 1, 1],
        [0, 0, 0, 0, 0, 0, 0, 0, 0, 0, 1, 1, 0, 1],
        [0, 0, 0, 0, 0, 0, 0, 0, 0, 0, 1, 1, 1, 1]
    ]
  }