{
    "grid": [
        [0, 0, 0, 0, 0, 0, 0, 0, 1, 1, 1, 1, 0, 0, 0],
        [0, 0, 0, 0, 0, 0, 0, 0, 1, 1, 1, 1, 0, 0, 0],
        [1, 1, 1, 0, 0, 0, 0, 0, 1, 0, 0, 1, 1, 1, 1],
        [1, 1, 1, 1, 1, 1, 1, 1, 1, 0, 0, 0, 1, 1, 1],
        [1, 1, 1, 0, 0, 0, 0, 1, 1, 1, 0, 0, 1, 1, 1],
        [1, 1, 1, 0, 0, 0, 0, 1, 1, 1, 0, 0, 1, 1, 1],
        [0, 1, 1, 1, 0, 0, 0, 1, 0, 0, 0, 0, 0, 0, 0],
        [0, 0, 1, 1, 1, 1, 1, 1, 0, 0, 0, 0, 0, 0, 0]
    ],
    "start": [3, 1],
    "end": [3, 13],
    "controls": {
        "buttons": [
            {
                "position": [4, 9],
                "switch_type": "DUAL",
                "activation": "stand_only",
                "controls": [
                    [6, 3]
                ]
            }
        ],
        "controlled_cells": [
            {"position": [6, 3], "state": 0}
        ]
    }
}