{
    "grid": [
        [0, 0, 0, 0, 0, 0, 1, 1, 1, 1, 1, 1, 1, 0, 0], 
        [1, 1, 1, 1, 0, 0, 1, 1, 1, 0, 0, 1, 1, 0, 0], 
        [1, 1, 1, 1, 1, 1, 1, 1, 1, 0, 0, 1, 1, 1, 1], 
        [1, 1, 1, 1, 0, 0, 0, 0, 0, 0, 0, 1, 1, 1, 1], 
        [1, 1, 1, 1, 0, 0, 0, 0, 0, 0, 0, 1, 1, 1, 1], 
        [0, 0, 0, 0, 0, 0, 0, 0, 0, 0, 0, 0, 1, 1, 1]
    ],
    "start": [3, 1],
    "end": [3, 13]
  }